00111111111
00001000001
10111110111
10000010101
10101010101
10101000001
11101011111
10001010001
10111011101
10001000001
11111111101
